______________________
|NOMBRES DE VARIABLES|
¯¯¯¯¯¯¯¯¯¯¯¯¯¯¯¯¯¯¯¯¯¯

USUARIOS

Primer nombre: nombre
Apellido: apellido
Cédula: cedula
Nombre de usuario: username
Contraseña: password
Correo electrónico: email
Código de carné: cod_carne
Teléfono celular: telefono_celu
Teléfono de oficina: telefono_ofic

PERIODO

Año: anio
Tipo: tipo
Activo: activo

PASANTÍA

Compañia: compania
Email compañia: compania_email
Departamento: departamento
Dirección: direccion
Dirigido a: dirigido_a
Actividad: actividad
Actividades: actividades
Supervisor: supervisor
Cargo de supervisor: cargo_supervisor
Horario: horario
Teléfono celular: telefono_celu
Teléfono de oficina: telefono_ofic
Tiempo completo: tiempo_completo
Fecha de inicio: fecha_inicio
Fecha de fin: fecha_fin
